{
  "mines": [],
  "trees": [],
  "water": [
    [31, 2],
    [32, 2],
    [33, 2],
    [34, 2],
    [35, 2],
    [36, 2],
    [37, 2],
    [38, 2],
    [39, 2],
    [40, 2],
    [41, 2],
    [42, 2],
    [43, 2],
    [44, 2],
    [45, 2],
    [46, 2],
    [31, 3],
    [32, 3],
    [33, 3],
    [34, 3],
    [35, 3],
    [36, 3],
    [37, 3],
    [38, 3],
    [39, 3],
    [40, 3],
    [41, 3],
    [42, 3],
    [43, 3],
    [44, 3],
    [45, 3],
    [46, 3],
    [31, 4],
    [32, 4],
    [33, 4],
    [34, 4],
    [35, 4],
    [36, 4],
    [37, 4],
    [38, 4],
    [39, 4],
    [40, 4],
    [41, 4],
    [42, 4],
    [43, 4],
    [44, 4],
    [45, 4],
    [46, 4],
    [31, 5],
    [32, 5],
    [33, 5],
    [34, 5],
    [35, 5],
    [36, 5],
    [37, 5],
    [38, 5],
    [39, 5],
    [40, 5],
    [41, 5],
    [42, 5],
    [43, 5],
    [44, 5],
    [45, 5],
    [46, 5],
    [31, 6],
    [32, 6],
    [33, 6],
    [34, 6],
    [35, 6],
    [36, 6],
    [37, 6],
    [38, 6],
    [39, 6],
    [40, 6],
    [41, 6],
    [42, 6],
    [43, 6],
    [44, 6],
    [45, 6],
    [46, 6],
    [31, 7],
    [32, 7],
    [33, 7],
    [34, 7],
    [35, 7],
    [36, 7],
    [37, 7],
    [38, 7],
    [39, 7],
    [40, 7],
    [41, 7],
    [42, 7],
    [43, 7],
    [44, 7],
    [45, 7],
    [46, 7],
    [31, 8],
    [32, 8],
    [33, 8],
    [34, 8],
    [35, 8],
    [36, 8],
    [37, 8],
    [38, 8],
    [39, 8],
    [40, 8],
    [41, 8],
    [42, 8],
    [43, 8],
    [44, 8],
    [45, 8],
    [46, 8],
    [31, 9],
    [32, 9],
    [33, 9],
    [34, 9],
    [35, 9],
    [36, 9],
    [37, 9],
    [38, 9],
    [39, 9],
    [40, 9],
    [41, 9],
    [42, 9],
    [43, 9],
    [44, 9],
    [45, 9],
    [46, 9],
    [31, 10],
    [32, 10],
    [33, 10],
    [34, 10],
    [35, 10],
    [36, 10],
    [37, 10],
    [38, 10],
    [39, 10],
    [40, 10],
    [41, 10],
    [42, 10],
    [43, 10],
    [44, 10],
    [45, 10],
    [46, 10],
    [31, 11],
    [32, 11],
    [33, 11],
    [34, 11],
    [35, 11],
    [36, 11],
    [37, 11],
    [38, 11],
    [39, 11],
    [40, 11],
    [41, 11],
    [42, 11],
    [43, 11],
    [44, 11],
    [45, 11],
    [46, 11]
  ]
}
